000000000000000
000000000000000
111111111000000
011111110000000
011000110011100
011000110011100
011000110011100
111111111111111
111111111111111
111111111111111
111111111111111
111000111100011
111010111101011
001000100100010
001111100111110
