0001001000
0111111111
1111111111
1101001000
1111111110
0111111111
0001001011
1111111111
1111111110
0001001000
