0000110000
0001111000
0001111000
1111111111
1101111111
0110111110
0010111100
0111111110
0111001110
1110000111
