000000011000000
000000101000000
000001011000000
000001111000000
000001111000000
000011111100000
000010000100000
000010001100000
000010001100000
000010001100000
000010001100000
000010001100000
000011111100000
000010000100000
000011111100000
