1111111111
1010101101
1010101001
1010101001
1000001001
1110111001
1110111101
1110111101
1110111101
1111111111
