000000000011100
000000000011100
000000000011100
001100000011100
001100000011100
001100000111110
001100001111111
001100001111111
011110001000011
111111001011011
111111001000011
110001001011011
110001001000011
110001001111111
111111001111111
