000000110000000
000000101000000
000000101000000
000000101001110
000000101011111
000000101010001
111111101110001
100000101011111
011111101111110
000000101000000
000011111000000
000110011000000
000110011000000
000110011000000
000011111000000
