0000001110
0100011011
1100010001
1000001011
1000110110
1101110000
0111100000
0111000000
0111100110
0000111100
