0000110000
0001111011
0001111011
1101111011
1101111111
1101111110
1111111000
0111111000
0001111000
0001111000
