0111001110
1111111111
1111111111
1101111111
1101111111
0110111110
0111111110
0011111100
0001111000
0000110000
