0000111100
0000111110
0000111111
0000100111
0000100011
0000100011
0000100010
1111100100
1111100000
1111100000
