1010011110
1010111111
1110110011
1001101101
1001100101
0101111101
0100100011
0100011111
0010000000
0001111111
