111111111111111
111111111111111
111110100000100
111110100000111
110110100000101
111110110001100
110110011111000
111110111111100
110110100000111
111110100000101
111110111111101
110110111111111
110110011111000
111111111111111
111111111111111
