0000110000
0001111000
0011111100
0111111110
1111111111
1111111111
1111111111
0110110110
0001111000
0011111100
