0000110000
0000100000
0111011110
1101111111
1111111111
1011111111
1011111111
1101111111
0111111110
0011111100
