000001111000000
000011111100000
000111001110000
000101001010000
000101001010000
000101001010000
000101001010000
000111111110000
000111111111000
000111000001100
000101111111100
000100100100100
000100100100100
000100100100100
000000100000100
