0000111000
0001111100
0011011110
0110001111
1100000111
1101110101
0101010101
0101010101
0101010101
0111111111
