0111111000
1100001100
1000000100
1000100100
1001010100
1000101110
1100011011
0111110101
0000011011
0000001110
