0000111110
0001001001
0001110111
0000111110
0111100010
1000100010
1011100010
1110111110
0000010100
0000010100
