0001100000
0011110000
0010110000
0001100111
0010010101
0010010101
1110011101
1110011111
1111111100
0111111000
