0011111110
0011111111
1111111111
0010100111
1110100111
1000000001
1111000001
0111100011
0010000110
0001111100
