0000110000
0000111000
0000101100
0000100110
0000100011
0000111111
0000100000
1111111111
0110101011
0011111110
