1111111100
1000000100
1001111100
1010110000
1011011000
1011101100
1010110110
1110011011
0000001101
0000000111
