0011100000
0101100000
1111100000
0011000000
0111000001
0110011111
1111110011
1110000111
1111001110
0111111100
