1111100000
1100010000
1001111000
1011111100
1011111110
0110111111
0011011111
0001101111
0000110110
0000011100
