0011100000
0011110000
1110010000
1011010000
1110011111
0110100001
0110100001
0010011111
0011000010
0001111100
