0001010100
0001010101
0001010101
0001010101
0001111111
1101111111
1111111111
0111111111
0011111111
0001111110
