0000000000
0000000000
1111111000
1011111111
1011111111
1111111011
1011111011
1111111110
1111111000
0111110000
