0001111000
0111111100
0111100010
1111000000
1111000000
1111000000
1111000000
0111100010
0111111100
0001111000
