0001000000
1111111100
0001000000
0011100000
0101100001
1111111001
1111111111
0010000100
1111111111
0000000000
