0000111100
0001111110
0001010110
0001010010
0111111111
1011111111
1111111111
1111111111
1101111001
0111001110
