0000110000
0011111100
0111111110
1111111111
1111111111
1010100101
0000100000
0000100000
0000101000
0000011000
