0011111000
0110111100
0101111100
0101111100
0111111100
0111111100
0011111000
0000100000
0000100000
0000011000
