000110110110000
000111111110000
000011111100000
000001110000000
000111011110000
001100000111000
001000000011000
001011111111000
001000000111000
001101111111000
000100000110000
000101111110000
000110011100000
000011011000000
000001110000000
