000001100000000
000001100000000
000001100000000
000111111111000
000000111000000
000001111100000
000011111110000
000111111111000
000100001111000
000101101111000
000100001111000
000111111111000
000011111110000
000001111100000
000111111111000
