0011001100
0001001000
0001001000
0001001000
0001001000
0010000100
0101111010
1011111101
1000000001
1111111111
