000000000000000
000011111100000
000100000010000
000111111110000
000101111110000
000101111110000
000111111110000
000111111110000
000111111111100
011100000011110
111100000011110
111111111111110
111111111111100
011111110000000
000000000000000
