000000000000000
000000000000000
000000000000000
000000000000000
000010000000011
001111100001111
011111110111100
100000001110000
111111111100000
101111111000000
101111111000000
111111111000000
000000000000000
000000000000000
000000000000000
