000000001111100
000000010101010
000000010111010
011110011000110
010010001111100
111111111111111
100111111100101
100111000111101
100110111011101
101101101101101
101101011101101
101101111101101
101110111011101
101111000111101
111111111111111
