0011111100
0110000110
1011001101
1001001001
1001001001
1001001001
1001001001
1011001101
0110000110
0011111100
