001110011100000
001011110100000
001011111111000
001011111111000
001011111111000
001011111111000
001011110100000
001110010100000
000000010100000
000000010100000
000000010100000
000000010100000
000000010100000
000000010100000
000000011100000
