000000000000000
000000000000000
001111111111100
010011111111110
100001111111111
101101100100111
100001101010111
100001101010111
100001101110111
100001111111111
111111111111111
000000010100000
000000010100000
000000010100000
000000010100000
