011111111111110
011011111111110
011111111111110
001010000010100
001011111110100
001011011110100
001001011100100
001000111000100
001001000100100
001010000010100
001011111110100
001011011110100
011111111111110
010111111111110
011111111111110
