0000110000
0001111000
0001111000
0110110110
1111111111
1111111111
1111111111
0110110110
0000110000
0011111100
