1110000111
1111111111
0100000010
1000000001
1011001101
1001000101
1011001101
1100110011
0110000110
0011111100
