1110000000
1011100000
1011111000
1011111111
1011111111
1011111100
1011111000
1011100000
1010000000
1010000000
