0000010000
0001111100
0001111100
1101011111
0101111101
0101011101
0111011101
0111111111
0001111100
0001111100
