0000000000
0000010000
0000111000
0001011100
0010111110
0110111110
0111111111
0111000111
0010000010
0001111100
