0001111100
0111000110
0100000011
1101111001
1001001001
1001001001
1001111011
1100000010
0110001110
0011111000
