000000000000000
000110110000000
001011101000000
000001000000000
000001000000000
000001000000000
001111110000000
011111111000000
011111111100101
110111111110111
111111111110111
111111111111110
011111111111100
000000000000000
000000000000000
