0000110000
0000110000
0001111000
0011001100
0010011100
0010011100
0111111110
1000001111
0111111110
0000110000
