1100000111
1000000011
0000000001
0101000001
0101001101
0000000100
0111001100
0010000000
1000000001
1110000111
