0000011111
0000010001
0000010001
0000010001
0001110001
0111011001
1101001111
1000101001
1000111001
1111101111
