0111111110
1111111011
1100000011
1100000011
0000011111
0000111110
0000110000
0000000000
0000110000
0000110000
