000001111100000
000011111110000
000110110111000
000111111111000
000101101101000
000111111111000
000111111111000
000110111101000
000100010001000
000100000001000
000111111111000
000000101000000
000000101000000
000000101000000
000000111000000
