001111110000000
111111111100000
111011011111111
110000001110001
100100100100011
110000001100110
011011011001100
111111111101000
100101000111000
110101001110000
011101111011100
000100000110110
000111111111110
000000110100000
000000011100000
