000000000000000
000000011111000
000011111011100
000111111101100
001100011101110
001000001110110
011001001110111
010011100111011
110011100111011
100001000011101
100000000011101
110000000111110
011111111110000
000000000000000
000000000000000
