000000000000000
000011111110000
001110000111100
011000000111110
010000001111110
111111111111111
100000000000001
010010001100110
001111111111110
001111111111100
010000000111110
010000001111110
011000011111110
001111111111100
000000000000000
