000111111110000
011111111111110
111111111111111
111110000011111
111101000101111
111101000101111
000011111110000
000111111111000
000111000111000
001110111011100
001110111011100
011110111011110
011111000111110
011111111111110
011111111111110
