000000000001110
000000000001110
000000110000100
000000111111100
000001111000000
000011111100000
000100000110000
000100000110000
011111111111100
011111111111100
001000000011000
001001110011000
001000000011000
011111111111100
011111111111100
