000011111110000
000110000011000
001100000000100
001011111110100
001111111111100
011111111111110
001111111111100
001011111110100
001000000000100
001001100000100
001101100001100
000100000001000
000101100001000
000100000001000
000011111110000
