011000000000000
101100000000000
111100000000000
001100000000000
001100000000000
001100000000000
001111111000000
001111111110000
000111111111000
011111111111000
111011111111100
111000011111100
011100111001110
001110111100111
000000011111000
