000000000000000
000001111000000
000001011000000
000001011000000
000001011000000
000001011000000
000111001110000
001100001111000
001001010111000
011011011011100
010010001011100
010010001011100
011011011011100
001101010111000
000111111110000
