000011111000000
000110101100000
000111011100000
000110101100000
000011111000000
000000100000000
000000100000000
000000100000000
000000100000000
000000100000000
111000100001111
011110101111110
001110101111100
001111111110000
000011110000000
