000000110000000
000000111000000
000000101000000
000011101110000
000110101011000
001101010101100
001011010110110
011010010010010
010010010010010
010010010010010
010010010010010
011011010110110
001101010101100
000111111111000
000001010100000
