000111111111000
000100000001000
111100000001111
101111111111011
111100111001111
111101101101111
111101000101111
111101010101111
000001010100000
011101000101110
010100101001010
011100101001110
011101111101110
000010000010000
000011111110000
