000000111100011
000001111111111
000011001111111
011110011111111
111000111111111
111111110101111
111111111111111
111111111000001
100000000100001
111111111111111
001010000010100
111111111111111
100000000000001
010000000000001
011111111111110
