000000000000000
000000000000110
000000000011011
000000001100111
000110110011111
001001001111111
000111111111111
000011111111110
000111111100110
001111111000110
111111110000110
111111100000110
000000000000000
000000000000000
000000000000000
