000000000000000
000011111111011
001110100001100
011100111111111
010100111111111
110000111001101
111001111001101
111111001001101
111110000001101
111110000011101
011111001111111
011111111111111
001111111111111
000011111111011
000000000000000
