110000000000011
101000000000101
101111111111101
101010000100101
110010000100011
000010110100000
000010110100000
000001111100000
000001110000000
000001110000000
000001110000000
000111110000000
000100010000000
000100010000000
001100011110000
