000001111100000
000011111110000
011111111111110
010011111110010
010000111000010
110001111100011
110001010100011
111000111000111
111111111111111
110000000000011
011111111111110
000100000001000
011110000011110
111111111111111
111111000111111
