000000000000000
000000000000000
111110001100000
101111101110000
110111101011000
111011111011000
111101111011100
011110111011100
011111011011100
000111101011100
111111110111100
110000001011000
011111111101000
001111111110100
000011111001100
