000111100000001
011111111100011
000001111110110
000000001111100
000000000001000
000000000011000
111111111101100
111111111011100
111111111011100
111111110111000
011111110111000
000011111000000
011101110111000
010100000101000
011100000111000
