001001010000000
001101110000000
000111000000000
000100000000000
001110000000000
010100000000000
111110000000000
001111111111100
000111111111110
000111111111110
000011111111110
000001100001100
000000100000100
000000100000100
000001100001100
