000011000111100
000001101100110
000000111000011
000001111000110
000011011111100
000010011100000
000010001110000
000110001110000
001100000111000
011000000111100
010000000111100
010000000111100
011000001111100
001100111111000
000111111110000
