000111110000000
111100011100000
100100000111000
111100100101110
000100100101111
111100100101111
100100000111011
111100011100011
000111110000011
000000000000011
000000000000111
000000000111111
000001111111110
011111111110000
111111100000000
