000000111000000
000000101000000
000111111111000
001100000001100
011000000000110
010000000000010
010000000000010
111111111111111
100000000000001
111111111111111
010000000000010
010000111000010
011000111000110
001100010001100
000111111111000
