000000111000000
000001111100000
000001111100000
000011111110000
000010000010000
000011010110000
000010000010000
000111111111000
001100111111100
011001111111110
110011111111111
111111111111111
111111111111111
010001000100010
001110111011100
