000011011000000
000110001100000
000110001100000
011111111101110
011110000111110
001110001111000
000100110111100
001100111111111
001001111111111
010001111111111
010101111111111
010011111111111
001110001111111
000000000111111
000000000111111
