111111110100000
111000110100000
110110011011001
110100011100011
110000011111111
111000111110000
111111111101111
110011111011111
101001111011111
100001111110101
110011111100101
111110111110000
111100010001001
111110111110000
111111111111100
