000000110001100
000001011010110
000001111011110
000011111111111
000100100001001
000100100001111
000100100001001
011111100001111
100000010001001
100000111001001
101110010011101
110001101100011
101110101011101
111011111110111
001110000011100
