000001111100000
000010000010000
000010111010000
000010111010000
000011111010000
000001110010000
000011000110000
000110000011000
001100111001100
011001101100110
110011000110011
100110000011001
101111111111101
100000000000001
111111111111111
