000000000011100
000000000110110
000000000100010
000000001100010
000000001000110
000000001101100
000111111111000
000100000100000
000111110100000
000100010100000
000111010100000
000100010100000
000111110100000
000100000100000
000111111100000
