000000000000000
000000000000000
000111110000000
011100011100000
010000000100000
110000000110000
100000101010000
100000111011100
100000101011110
100000000111111
111000011111111
001111111111110
000001111111000
000000000000000
000000000000000
