001000000001000
001100000111000
001111111111000
001000100011000
001010101011100
011000100011100
011111011111110
011001010011110
011000100011110
011010001011110
011010101011110
011000100011100
001100000111100
000111111111000
000101110100000
