000000000000000
000000000000000
000111111110000
001100000011000
001111111111111
001111111111111
001101111111001
001101111111111
001111111111110
001101111111100
011111111111110
010111111110010
010011111100010
011000000000110
001111111111100
