000011111110000
000110000011000
000100000001000
000100101001000
000100000001000
001100111001100
011110000011110
110011111110011
100000000000001
100000000000001
100000000000001
100000000000001
110000000000011
011000000000110
001111111111100
