000000011110000
000000110011000
000001100001000
000001000111000
000011001100000
000010001000000
000110011000000
000100010000000
000100110000000
000100100001111
001100100111111
001000101111111
001000111111111
111110001111011
111110000001110
