000000000000000
000000000000000
000111111111110
001111111111111
001001101010101
001001101010101
001011111111111
111111111111111
111111111111111
111111111111111
111111111111111
111001111110011
001001000010010
001111000011110
000000000000000
