111111101111111
111111000111111
111111000111111
111110000011111
111110000011111
000000101000000
100000101000001
110000101000011
111000000000111
111100000001111
111000000000111
111000000000111
110000010000011
110000111000011
100011111110001
