000111001110000
000101001010000
000101111010000
000101001010000
000111001110000
000100000010000
000101111011000
001101001001000
001001111001100
001000000000100
011000000000100
010000111000100
011111101111100
010001001000100
011111001111100
