000000000000000
000000011110000
000000111111000
000001100001100
000001100000110
011001100000010
111101111111010
110110000000110
011000110000001
001001100001101
001001100001101
001001100001101
001001100001101
000111111111110
000000000000000
