000001111000010
000011001100001
000011000110011
000000000010111
000011000000111
001111110001101
011111111001101
111111111100110
111111111100000
111111111100000
111111111100000
111111111100000
111111111100000
011111111000000
001111110000000
