111111000000000
100101110000000
100100011100000
101011000111000
101000110001111
101000001110010
101011000100100
111101001111011
100001001001011
110001001001000
011111111111111
000100110010000
000111111111111
000111011010101
000011101111111
