111100000000000
100111110000000
110001011000000
011111011000000
010000011000000
010001011000110
010000011001111
011110011111111
000100001110101
000100001110101
000100000000100
000100000000100
000101011110100
000101010010100
000111110011100
