111111000111111
111110000011111
111100101001111
111100101001111
111100000001111
101100010001111
100110000011101
000110101011100
110011111110000
111000111000111
111110001111111
111111100011111
011100111000000
000001111110001
100111111111101
