000011111110000
000111111111000
001111110111100
001111110111111
001111111111000
000111111110000
000011111010000
000111011001000
001111011000100
001111011000100
011111011000100
011110111001100
011101111001000
001111110010000
111111101111110
