000111000000000
000100100000000
111110100000000
100100100000000
111111100000000
000111110000000
000111101111111
000111011110001
000111011111111
000111011111100
000011101111110
000011110000100
000001111111000
000000010100000
000001111100000
