000000000000000
000011111110000
001111110011000
011000011101100
010000001111100
110000001111110
100000000111110
110101010111110
100000000111110
110101010111110
100000000111110
110101010111110
100000000111110
111111111111000
000000000000000
