000011100000000
000100011100000
001011100010000
001010011101000
001010000101000
001011100101000
001111111101000
001000011111000
001000000011000
010101100111000
010011111011100
010001100001100
010000000001100
011111000001100
000000111111000
