000000000000000
000000000000000
000111011100000
001001111111000
011101111111100
111111111111100
100011111111110
011111111111111
000001111111111
000011110011011
000110010001001
001100110011001
000000000000001
000000000000101
000000000000111
