000001110000000
111111000000000
101010000000000
101010000001100
101010001111100
111111000011100
000111000010000
011101000100110
111101000101111
101101111111101
100101100001101
100101111111101
100100100001001
111100111001111
011000000000110
