000000111100000
000011100100000
000110001100000
000100111110000
001100000011000
001111110001000
001100000011000
000111111110000
000101010110000
000111111110000
000010101100000
000011111100000
000001111000000
000001111000000
000000000000000
