000000000000111
000000000111100
000000001111100
000000011101100
000000011111100
000000010111100
000000111111000
000001111110000
001111110100000
011011111100000
011111011000000
111111111000000
101101110000000
111111100000000
011110000000000
