000011111110000
001110000011100
011000000000110
010000000000010
110000000000011
100000000000001
100000000000001
100000000000001
110000000000011
101000111000101
101101111101101
010101110101010
011101111101110
001101111101100
000000111000000
