000000000000000
000000000000000
000000000000000
000110000000110
001101000001101
001001000001001
011000000011000
010000000010000
111111111110000
101110101110000
101110101110000
011100011100000
000000000000000
000000000000000
000000000000000
