000011000000000
000010000000000
001110000000000
011010000000011
111110000000111
111111000000100
110111111111100
000011011011000
000011000011000
000011111111000
000001100110000
000001100110000
011011000011011
001111111111110
000111111111100
