000000000000000
000000000000000
000000000000000
000000001111110
011110011000001
111001111111111
100101010000011
100101010000101
100100000001001
110100000001001
011111111111110
001111100111110
000000000000000
000000000000000
000000000000000
