111111111111111
110000000000011
110111111111011
110110000011011
110110000011011
110110000011011
110110000011011
110111111111011
110000000000011
110010000000011
110111000000011
110010000111011
110000000000011
110000000000111
111111111111111
