000000000000000
011100111000000
111111111101110
111000011101011
111000011101001
110100101101101
110100101100101
010000001111101
010011001000111
011000001000011
001111110000001
001000000000001
001000000000001
001001001111001
001111111001111
