000000010000000
000000010000000
000000111000000
000000101000000
000001101100000
111111000100000
100011010111110
111111000100011
100011010101011
101011000100011
100011010101011
101011000100011
100011010101011
101011111110011
100010000010011
