000000010000000
000000010000000
000000010000000
000000010000000
011100010001110
110100010001011
101111111111101
110000000000011
100000000011001
100110000000001
101111001101101
101111000000001
100110000011001
110000111000011
011111000111110
