000000000000000
000011010010000
000001011100000
001110110011100
011111001111110
011111111111110
111111111111111
111111111111111
110011111111111
110011111111111
111111111111111
011001111111110
001111111111100
000011111110000
000000000000000
