000000000000100
000000011101100
000000001111000
000011111111100
000110010111110
001101000011111
001000010001101
001101000101100
011000010001100
010101000101100
010000010111100
010101111111000
011111111100000
001111110000000
000000000000000
