000000000000000
000000111111000
000011100001110
000010001100110
000110000000111
000111111001111
011100001111111
010001100111111
110000000011110
100000000011000
100000000111000
110000001111000
011111111110000
001111111100000
000000000000000
