010100000000000
011100000000000
010100001100000
111100011110000
101101111111100
001101111111110
001111111111111
001111111111111
000111111111111
000001111111011
000001101110011
000001100000011
000000100000001
000000100000001
000001100000011
