000000000011000
000000000111000
000000000111000
000000000111100
011111100011110
011111101011111
000000001001111
111111101001111
111111101000111
000000001100001
011111101111111
011111101111111
000000011111111
000111111111110
000111111000000
