000000000000000
000111000000000
001111110000000
001011111000000
001111101100000
010111000110000
010000000011000
011110000001100
011111111000110
010001111111110
011110000111110
011111111000010
011111111111110
000001111111110
000000000111110
