000000000011100
000000000111110
000000000101111
000000000100111
000000001110011
000100011011110
001110110110000
011111101100000
111111111000000
111111010000000
111110011000000
111100111100000
111111111000000
111111110000000
111111100000000
