000000101000000
100001111100001
110010111010011
010011111110010
011110000011110
000111111111000
011101111101110
100100111001001
101000111000101
001000010000100
001000010000100
010000111000010
010001111100010
011011000110110
001110000011100
