111111100011111
111111100111111
110001111100011
100000000000001
000000000000000
000111101111000
001111101111100
001001101100100
000000000000000
000000000000000
001100110010100
001111111111100
100101010011001
100000000000001
110000010000011
