011000000011110
100100000110011
100010011100001
110010110000001
101101100000011
100011011000010
100110001110110
100100000001100
101100000011110
101000000111010
111000001111110
111000011111110
011001110001010
001111000001010
000000000001010
