011111000100011
010000111011101
011110001010011
100010100000110
100101111111000
100000100000000
111100111111100
000100000000011
000100000000101
000100000000101
000100000100111
000101111100100
000101000010100
000101000010100
001011000101100
