000001110000000
000010011000000
111110001000000
100010101000000
111110001000000
100010001000000
100010011111111
100010010000001
110010010000111
011110001000001
000001000111111
000001100000011
000000111111110
000000000010000
000000011110000
