000000000011000
000000000111000
000000001101100
000000011001100
000000110000100
000001101100110
100011000111110
100110000000010
110100011001111
011110001111111
011011100000011
001111110000111
011011111111111
010010101111110
010010100000000
