001100000001100
011110000011010
011011111111010
011000011100010
010000111100011
010000001000001
010110011101101
110111001011101
111000000000011
111100011100111
011001011100011
011101001001011
001111111111110
000111100011100
000000111110000
