000000100000000
000001110000000
000101110100000
000111111100000
000011011100000
000111110110000
001110111110000
001111100001000
011011101111100
111000011101110
001111111111000
000000110000000
000011111100000
000011111100000
000001111000000
