000001110000111
000001011001101
000001001111001
000001100000011
001111001001001
011001001001001
110001100000011
100000011001110
100100000110010
100100010000010
100110110010010
100011110010010
100001110010011
111000011001001
001111111111111
