001100001000000
011000000100000
111100000100000
101110110101100
000101111001000
000011110110000
000111101111011
000111001111101
100010110111101
011101111011110
000001111101110
001110111110110
000000011111100
000001000111000
000001100000000
