000000000011100
000000000001110
000000000000111
011110000000101
110011000001100
101111000111000
111111111101000
111111000011000
011110000010000
000000111110000
000001100110000
000001011110000
000001111110000
000001111110000
000000111100000
