001111100000000
110000010000000
100111001000000
101010101001000
101010101001000
101000101001001
100110101001101
100010100101111
100100010100111
101001010100110
101001011101110
101110011111110
100100111111110
010111111111100
011111111111000
