000000000000111
000000000001110
000001000011100
000001000010100
000001000010100
000001000010100
000001011111110
000001010000010
111111010101010
100011111111111
010000000000001
011111111111111
010000000000001
001000000000010
001111111111110
