001110000111000
001011111101000
001010000101000
001100010111000
011110010011000
100000000010110
101010100000011
100000111000101
111111101000101
100110001000101
111101110000111
000100000000100
000101110110100
000101010110100
000111011111100
