000111100000000
000110100000000
000110110000000
011100101100000
110111100011000
100000000001100
100000000000110
111111000000010
010000001111011
001110011000001
000010010000001
000010010001101
000110111100101
000100100000111
000111111111110
