000000000001111
000000000011011
000000000110110
000000000011110
000000000111000
000000001110000
000011110100000
001111011000000
111110101100000
111101011111100
110010111111100
111001111110000
111101110000000
011111100000000
001111100000000
