000001111000000
000011111100000
000011100000000
001111110001100
011111111011110
111101111110011
101101111111111
111101001110111
111001011011011
011011111011111
001111100011011
000000110001011
000000111000011
000000000000011
000000000000010
