000000111000000
000011111110000
000011000110000
000010101010000
111110000011111
110011000110011
010001111100010
011000110000110
001101100011100
000111111110000
000010000010000
000011111110000
000001000100000
000001100110000
000000110011000
