000001100000000
000001100000000
000011111000000
000011111100000
010111110110000
111101110010000
010001110111111
010011100010000
010011110000001
010001111000110
010000011111011
010000001111100
010000111110000
000011011000000
011101100000000
