000011101110000
000110000011000
000111000111000
000100000001000
000110000011000
000011111110001
100100000001001
110111111111011
011011111110010
000100000001000
110111101111000
000111101111011
010111101111001
010111101111000
010011101110011
