000011000000000
000101000011000
000011000111000
000011111110000
000011111110000
000001111100000
000000010000000
001000010000110
110111111111001
001000010000110
000000010000000
000000101000000
111111111111111
101110111011101
011101110111011
