000001110000000
000011011100000
000010010010000
000010001010000
000100000010000
011100000010011
110100000011101
100100000011101
100110000110101
101111111110101
101011111101001
100001111001011
110000000010110
011000000111100
001111111110000
