000000000000000
000000001000000
000000010100000
001000010100001
001100100010011
001010100010101
001001111111001
001011111111001
011111100011101
100111100011110
011011100011111
101101111111000
111110011100111
000111100011110
000011111111100
