000001111100000
000110011111000
001100111110100
011001111110010
011111111111010
111111100011111
111111100011101
110011100011001
110011111111001
111111111111111
011101000101110
001001000100100
001000000000100
001100000001100
000111111111000
