000000001000000
000000011000000
000000010000000
000001111100000
001101101111000
001100000011000
000001101101100
001101101101100
001100011011000
000011011011000
000011001100000
000000111100000
000000110000000
000001100000000
000001100000000
