000000000000010
001111000000111
011111100000111
110011100000010
100011100000010
111011000000010
000101000111010
001111111111110
011111100111110
011111100111100
001111111111100
000101000100100
000101000010100
000111000011100
001111000111100
