001001010100100
010110101011010
010101111101010
010101101101010
011101101101110
010111101111010
100101111101001
101000101000101
101001000100101
101001000100101
101001000100101
111001000100111
001101000101100
000111101111000
000000111000000
