011110000000000
011111000000000
111001000000000
110010100000000
110001100000000
010111000111000
010001000100100
111001111111111
101101110000001
110100010000011
010111110000010
010000000000010
010000000000010
010011111110010
001110000011100
