011111000000000
111111100000000
011111000000000
000000000000000
001110000000000
011111000000000
001110000000111
000000000001111
111111100011100
100111100111000
100111111110000
111111111100000
100111111000000
011111110000000
001111000000000
