011000000000000
011101111100000
001111111110000
000111110011000
001111100001100
001111000000100
001110000000110
001101100000010
001111110000010
000111111000010
000011111111010
000001111111110
000000011111110
000000000000000
000000000000000
