000110001110000
011111011111000
011111011111100
110011111001100
100110111100110
101100010110010
001110111011000
001011101001000
001000111100000
000000010100000
000000011100000
000000010100000
000000011110000
000000010010000
000000111111000
