000111110000000
011001001100000
100000000010000
111111111110000
000100110000000
000100100000000
001110111100000
011100111100000
011101111110000
111111111110000
111111011111000
111111101111000
011000001110000
000111111111100
000111111100111
