000000000011100
000000010000110
000000010000010
000011111110110
001110010011100
011000010000110
010000000000010
011100000001110
010111111111010
011000000000110
001100000001100
011111111111000
110011111110000
110000111000000
011110010000000
