000011110000000
000010010000000
000011011100000
001110010010011
011011111011101
111100000111001
100101000001101
110101100001001
100100101001101
100100110001001
111100000001101
010000000111001
001100011101101
000011100100011
000000111000000
