000011111100000
000100000110000
001010010011000
011000000001000
010010010001100
010010010000100
010011110000110
010101001000010
010110111000010
010000000000011
001000000010001
001000000010001
011010001011001
100010001000101
111111111111111
