000010111010000
000001111100000
000111111111000
000111111111000
101000010000101
011111101111110
001100101001100
001100101001100
111111101111111
001111101111100
001100101001100
011100101001110
100111101111001
000011101110000
000000111000000
