000000111000000
000001111100000
000111111111000
000001000100000
110001000100011
011111101111110
001000111000100
001000001000100
001110101011100
000010001010000
000010111010000
000010111110000
000001111010000
000001011000000
000000011000000
