000111100000000
000100100000000
001110100000000
110100110000000
100011010000000
111110010000000
000100110000000
001001100000111
011001000111111
010011111111101
010011111111101
010001111111001
010000111110011
011000000000110
001111111111100
