001111100001100
011010110011110
110101010011110
111010101001100
110101011000000
111010101000000
111101011000000
011111111000000
000111111100000
000000011010000
000000001101000
000000000110100
000000000011110
000000000001111
000000000000110
