000110000011110
011001000110010
011001001100100
111110011001011
100111110010101
100111111101001
011011111010011
000110111100110
001101011111100
011001011110000
110010101011000
100101001011100
101010011001110
110100110000111
000111100000011
