000000000011111
000000000110001
000000111011001
000001010001111
000010010000001
000110011000001
011110001100011
110011000111111
100001100000001
101010100000001
101010110000011
101010011000110
110000001111100
011000111000000
001111100000000
