001111111110000
011111111111000
111010001011100
100110001100100
100100100100100
001100100110000
011000110011000
010001110001000
010011111001000
010011011001000
010011011001000
011001110011001
001101010110111
000111111100001
011111111111000
