000111111111000
001100000001100
001000101000100
001000101000100
001000101000100
001000000000100
001110000011100
000011111110000
100000010000001
111100010111111
100111011100001
110001111000001
010000111000011
011000110011110
001111111110000
