111111100110001
111111001100011
111111011000111
111110111011110
111110111111100
111100011111001
111100011111011
000000000001110
100010100011100
110010100111000
111000001110011
110000000110111
110001000111111
100011100011111
101111111011111
