001000000011110
001100000110011
001110000100001
001111110100001
011111100110011
011100000011110
011000000001100
111000000001100
111100000010110
111100000011110
011111001111110
011111111110110
001111111111010
000111111011100
000011111101111
