000000000000111
000000111000101
000011101100101
000110000111011
000111000010001
011101110001011
010101011000110
010110010101110
010000010001010
010010110011010
010000101011110
010000100110000
100011111010000
100110010010000
111100011110000
