001110000000000
010001000000000
100010000000000
100110101001100
101011010110010
101011111111001
111110000010101
010100000001111
010111111111010
001100000001100
110011111110010
101110000011101
101011111110101
101010000010101
111110000011111
