011111111111100
010000000011000
010000000001101
010000000100111
011100000000011
000111000001001
000001000000001
000001000000001
011001100000001
010011111100001
110011000100001
100011000110001
100010000010001
110110000011111
011100000000000
