000000001111000
000000011001000
000111110001110
011100000000011
110000000001001
100000000001101
100100000001001
100000110001101
110000010001001
100000110001101
110000000001001
011100000000011
000111110001110
000000011001000
000000001111000
