000000011111100
011111110000100
010000010000100
010000110000100
010000100000100
011111100000100
000001000000100
011111111111111
100000000000001
101111111111101
110001000100011
100000101000001
100000101000001
110001111100011
011110000011110
