000000011000111
000000011001111
000000010011111
000000001111110
000000111111100
011101111111000
111011111111011
000111111110111
000101111110000
001111111100000
011001011000000
110001110100000
100011001100000
110110001100000
011100001000000
