001110000000010
011011000000110
010111000001110
110111100001010
101111111000100
111111111111000
001111111111110
000011111111111
000001111111111
000000111000111
000000110000011
000000010010011
000000010000011
000000011000110
000000001111100
