000001111100001
000010101010011
000101010110111
001110101001110
001100000011100
011000000111010
010000001110010
111111111111111
100000000000001
110000000000011
011000000000110
001111111111100
000000101000000
000011000110000
001111111111100
