000011001000000
000100100100111
001010100101100
010110101010000
101101110100000
100111101101110
011111101111011
000010011111001
100111111001101
011001110011101
000111110111100
001010111111000
011010001110000
010001000000000
010000111100000
