000000000000110
000000000000010
000000000111110
000000000001110
000000000110110
000000001111010
000000011111000
000000111111000
000001111110000
000011011010000
000111100110000
001101111100000
011110011000000
111111110000000
000000000000000
