000111001111000
000101101001110
011100111000011
110000001100001
100100100110001
100100110011001
100000011001001
011110001001101
110100111100101
101001100100101
101011000010101
101101000000101
110011110000101
011110000010011
000011111111110
