000001111100000
000010000010000
000101111101000
001101111101100
010100111001010
010010111010010
100010010010001
100001000100001
100000111100001
100100000101001
100100000101001
111100010101111
100100010101001
111100000101111
001111111111100
