000011111110000
111110010011111
100010010010001
100010111010001
100011100110001
100000100000001
111000100000111
001010101010100
001000101010100
001010101110100
001000100000100
001010100000100
001000100000100
001110100011100
000011111110000
