000000000010000
000001111100000
000001000100000
000001100100000
000011110100000
000111111100000
001111100000000
011111000000000
011110000000000
111100000011100
111011111110010
110111111110011
000011111110010
000000000011100
000000000000000
