000000111000000
000011111110000
000010000111100
001111010010110
011010000110010
010011001101111
010001111001001
111100000011111
100111111110010
111111111100010
010011111001010
010000111111011
110011111001001
100010000001111
111110000000000
