001111111000000
011010000100000
101000001000000
111100010000000
100101010000000
000111111000000
001111111110000
001011111111111
001001111111111
001100111111111
001100000000110
000110100011100
000001011110000
000000100000000
000011010000000
