000000111100000
000001111110000
011101111111000
111110101111000
110110101111100
111110001111100
111111111111100
111111111011000
011111100111000
001100011111111
000100011111111
001000011111111
001000110000111
000100100000111
000011111111110
