000000111000000
000000101000000
000000101000000
011001101100110
010101000101010
010101000101010
010111000111010
010010000011010
010010000010010
010000000000010
111000111000111
101000101000101
111000111000111
010000000000010
011111111111110
