000111111111000
001000010000100
001000010000100
001000010000100
010100111001010
010100101001010
100010101010001
100010101010001
111110101011111
011100101001110
000000101000000
001111111111100
010000000000010
010001111100010
011110000011110
