0110100100000000000000000
0101010000000110000000010
0010000000011100000000110
0000000001111000000001110
0000000011110000000011010
0011111111111111111111110
0101010101010101000001110
1110000000000000000011100
1111111111111101111110000
0000000001111110000000000
0000000110011111000000011
0000000111100111100001101
0000000000011101111000011
0000000000011110011110000
0000000000000000000110000
0000000000000000000000011
0000111110000000000001110
0111011111111100000100111
1111111111101000000011011
1011000101110000010111111
0000001110100000000000010
0000000000000010111110000
0011000000001001011101100
1110011000000110101111100
0011101100001111111001011
