000000001001000
000000010010100
000000010001111
000000010011110
000000001010000
000000001001000
101001110100100
111110001100101
111100000000111
001000011000111
000001110001111
110011000011111
111100001111111
111110110111111
111110011001111