000001111111110
000011111111111
000011100000011
011011000000001
101111101101101
100111001001011
110111100000011
011111100110111
001111000000111
000111000000011
001111100100010
001111100110110
011111100000110
111111110001100
111111111111000