0000000000011100111100000
0000000000101001010110000
1010000001110011100010000
0100000001010010100000000
0000000001110011100011110
0000111101010110101111101
0000010011101011110001110
0101111010000000000111101
1010111100000000011111111
1111111111001110001111111
1011011110001100010111011
0101111100000000010101101
1111111100000000010001110
1011111100000000001001100
0111101000000000001001100
0011001000000100001000110
0011010000000100000100110
0111011001000100000100110
0110010000001000000110011
0110010000011000000011011
0110001111111000000001111
1111111111111100000001111
1111111111100100000000111
1111111110000100000000111
1111110000000010000000011