0000000000000000000000000
0000000000001101110000000
0000000000010010010000000
0000000000010000010111100
0000000000011111111000100
0000000011111000011000110
0000000010110000001100001
0000000110100100100100001
0000000100100000000111110
0000000100101000010111000
0000000111101100110100100
0000000001110011000110100
0000000001011000011011100
0000000001100111101000000
0000001110010110110100000
0000001010011100011000000
0000001101001100000000000
0000000011111100000000000
0000000100001011000000000
0000011000001100100000000
0000110000000111100000000
0001100000000000000000000
0010000000000000000000000
1100000000000000000000000
1000000000000000000000000